00023%01%0%asd&
00022%01%0%asd&
00021%01%0%asd&
00020%01%0%asd&
00019%01%0%asd&
00018%01%0%asd&
00017%01%0%asd&
00016%01%0%asd&
00015%01%0%asd&
00014%01%0%asd&
00013%01%0%asd&
00012%01%0%asd&
00011%01%0%asd&
00010%01%0%asd&
00009%01%0%asd&
00008%01%0%asd&
00007%01%0%asd&
00006%01%0%asd&
00005%01%0%asd&
00004%01%0%asd&
00003%01%0%asd&
00002%01%0%asd&
00001%01%0%asd&
